XXXXXXXXXXXXXXXXXXX
XE..X....E.......EX
X...#...###...#...X
X...#...#...#.#...X
X...#...#...#.#...X
X..........X......X
X.###.....X..#.#..X
X...X...#.#.......X
XX#.X...#.#..#X#..X
X.#.#...###.......X
X.#..........#.#..X
X.#.#..@#X#..###..X
XXXXXXXXXXXXXXXXXXX