XXXXXXXXXXXXXXXXXXX
XE.......E.......EX
X.#.#.#.#.#.#.#.#.X
X.#.#.#.#.#.#.#.#.X
X.#.#.#.#X#.#.#.#.X
X.#.#.......#.#.#.X
X.......#.#.......X
XX.###.......###.XX
X.......###.......X
X.#.#.#.#.#.#.#.#.X
X.#.#.#.....#.#.#.X
X......@#X#.......X
XXXXXXXXXXXXXXXXXXX